{
    "default": [
        "............",
        "..x....x....",
        "..xxx..xxx..",
        "..xxx..xx...",
        "..xxx.......",
        "............",
        "............",
        "...xx..xxxx.",
        "..xxx..xxx..",
        "..xxx..xxx..",
        "....x...xx..",
        "............"
    ]
}