{
    "default": [
        "............",
        "..x....x....",
        "..xxx..xxx..",
        "..xxx..xx...",
        "..xxx.......",
        "............",
        "............",
        "...xx..xxxx.",
        "..xxx..xxx..",
        "..xxx..xxx..",
        "....x...xx..",
        "............"
    ],
    "map1": [
        "............",
        "............",
        "..xx....xx..",
        "..xx....xx..",
        "............",
        "....xxxx....",
        "....xxxx....",
        "............",
        "............",
        "..xx....xx..",
        "..xx....xx..",
        "............"
    ],
    "map2": [
        "............",
        "...xx..xxxx.",
        "..xxx..xxx..",
        "..xxx..xxx..",
        "....x...xx..",
        "............",
        "............",
        "..x....x....",
        "..xxx..xxx..",
        "..xxx..xx...",
        "..xxx.......",
        "............"
    ],
    "map3": [
        "............",
        "............",
        "..xxx..xxx..",
        "...xx..xx...",
        "...xx..xx...",
        "............",
        "............",
        "............",
        "...xx..xx...",
        "..xxx..xxx..",
        "..xxx..xxx..",
        "............"
    ],
    "map4": [
        "............",
        "............",
        "...xx..xx...",
        "..xxx..xxx..",
        "..xxx..xxx..",
        "............",
        "............",
        "............",
        "..xxx..xxx..",
        "...xx..xx...",
        "...xx..xx...",
        "............"
    ]
}